Amerykańska opowieść – amerykański film animowany z 1986 roku.

Opis fabuły
XIX wiek. Fievel jest młodą rosyjską myszą. Właściwie jeszcze dzieckiem. Razem z rodziną wyrusza do Ameryki, gdyż krąży opinia, że nie ma tam kotów, a na ulicach leży ser. Uczestniczą w tym też myszy  Włoch i Irlandii wierzące w to samo. Łączą je wszystkie tragiczne doświadczenia w Europie. W czasie podróży statkiem Fievel zostaje zmyty z pokładu i trafia do portu w Nowym Jorku. Tam, gdzie owy statek. Rodzina myśli, że zginął. Próbuje ich odnaleźć. Los mu jednak nie sprzyja: bajka o idealnym świecie w Ameryce okazała się czystą fikcją; gdy myślał, że słyszy skrzypce ojca, okazało się że to gramofon; liczy, że pomogą mu inne myszy, te nie zamierzają. Nieumyślnie wpada w zasadzki, z których cudem wychodzi cało. Prawie rozdeptuje go koń, wpada pod pojazd szynowy etc. Często wymija swoją rodzinę w niewielkiej odległości. Nie zauważają się, bo każdy patrzy w niewłaściwą stronę.

Główne role
Erica Yohn – Mama Mousekewitz (głos)
Nehemiah Persoff – Papa Mousekewitz (głos)
Amy Green – Tanya Mousekewitz (głos)
Phillip Glasser – Fievel Mousekewitz (głos)
Christopher Plummer – Henri (głos)
John Finnegan – Warren T. Rat (głos)
Will Ryan – Digit (głos)
Hal Smith – Moe (głos)
Pat Musick – Tony Toponi (głos)
i inni

Wersja polska
Amerykańska opowieść
W wersji polskiej wystąpili:
Katarzyna Tatarak – Fievel
Arkadiusz Jakubik – Tate
Katarzyna Łaniewska – Mame
Marian Opania – Tygrys
Mirosława Krajewska – Gussie
Włodzimierz Press – Warren
Jacek Bończyk – Digit
Elżbieta Futera-Jędrzejewska – Tony
Dominika Ostałowska – Bridget
Andrzej Blumenfeld – Uczciwy John
Beata Jankowska – Tanya
Jacek Jarosz – Henry
oraz
Dorota Chotecka
Monika Wierzbicka
Jarosław Boberek
Ryszard Olesiński
Mirosław Zbrojewicz

Wersja polska: Telewizyjne Studia Dźwięku
Reżyser: Barbara Sołtysik
Dialogi: Grażyna Dyksińska-Rogalska
Dźwięk: Jerzy Rogowiec
Montaż: Elżbieta Joel
Kierownik produkcji: Janina Ostała
Teksty piosenek: Andrzej Brzeski
Opracowanie muzyczne: Eugeniusz Majchrzak
Śpiewali: Beata Jankowska, Katarzyna Tatarak, Marian Opania, Arkadiusz Jakubik, Jacek Jarosz, Anna Apostolakis, Olga Bończyk, Katarzyna Żak, Monika Wierzbicka, Jarosław Boberek, Paweł Cippert, Dariusz Odija, Piotr Plebańczyk

Wersja na DVD (filmy 1-4)
Opracowanie wersji polskiej: Start International Polska
Reżyseria: Paweł Galia
Wystąpili:
Magdalena Krylik - Fievel
Brygida Turowska - Tony
Katarzyna Łaska - Bridget i Cholena
Joanna Węgrzynowska − Nelly
Zbigniew Suszyński - Reed
Grzegorz Pawlak - Papa
Mirosława Krajewska - Mama
Anna Sztejner - Tanya
Jakub Szydłowski - Tygrys

Linki zewnętrzne
