Pokémon: Film pierwszy (również Pokémon: Film pierwszy – Zemsta Mewtwo; jap. 劇場版ポケットモンスターミュウツーの逆襲, Gekijōban poketto monsutā: Myūtsū no gyakushū) – pierwsze pełnometrażowe anime o Pokémonach, wydane w roku 1998. W tym filmie możemy ujrzeć Pokémona drugiej generacji - Donphana. W Polsce film był wyświetlany w kinach, a także emitowany w: TVN - premiera 4 stycznia 2004, TVN Siedem - premiera 13 lutego 2005 ( wersja lektorska) i HBO - premiera w czerwcu 2002, HBO 2, Cinemax, Cinemax 2 ( wersja dubbingowa).

Wersja polska
Wersja z dubbingiem
Wersja polska: STUDIO SONICA
Reżyseria: Jerzy Dominik
Dialogi: Barbara Robaczewska
Dźwięk i montaż: Małgorzata Gil
Organizacja produkcji:''': Elżbieta Kręciejewska
Tekst piosenek: Lubomir Jędrasik
Kierownictwo muzyczne: Marek Krejzler
Piosenki śpiewali: Krzysztof Pietrzak, Ewa Skrzypek, Beata Molak
Wystąpili:
Hanna Kinder-Kiss – Ash Ketchum
Iwona Rulewicz – Misty
Marek Włodarczyk – Brock
Dorota Lanton – Jessie
Jarosław Budnik – James
Mikołaj Klimek – Narrator
Marek Obertyn – Mewtwo
Małgorzata Maślanka – Oficer Jenny
Adam Bauman – Giovanni
Cezary Kwieciński – Fergus
Jacek Kopczyński –
Corey,
trener-pirat
Krystyna Kozanecka – Neesha
Anna Bielańska – Siostra Joy
Anna Apostolakis – Miranda
Mirosław Wieprzewski – Meowth
Mieczysław Morański – Profesor Fuji
i inni

Wersja z lektorem
Wersja polska: dla TVN – MASTER FILM
Tekst: Dariusz Dunowski
Czytał: Piotr Borowiec

Zobacz też
Pokémon
Pokémon (anime)

Linki zewnętrzne
