Misiowanki (ang. The Berenstein Bears) – serial animowany produkcji amerykańskiej, emitowany w paśmie Wieczorynki w TVP1. Opowiada on o rodzinie Misiów.

Bohaterowie
Misiu - Starszy brat Misi. Uwielbia grać w siatkówkę i jeżdzić na rowerze. Zwykle nosi czerwoną bluzkę i zielone spodnie.
Misia - Młodsza siostra Misia. Zwykle chodzi ubrana na różowo.
Mama Miś - Mama Misia i Misi. Uwielbia robić na drutach. Zwykle chodzi ubrana na niebiesko.
Tata Miś - Tata Misia i Misi. Z zawodu jest stolarzem. W młodości był maratończykiem. Zwykle nosi niebieskie spodnie i wielki brązowy kapelusz.
Babcia Miś - Babci Misia i Misi.
Dziadek Miś - Dziadek Misia i Misi.
Fred - Kuzyn Misia i Misi. Nosi okulary i chce zostać wynalazcą.
Liza - Przyjaciółka Misi.
Karolka - Przyjaciółka Misi.
Misiek - Przyjaciel Misia.
Andrzej - Przyjaciel Misia.
Pan Misialski - Sąsiad rodziny Misiów.
Pani Niedżwiedzka - Sąsiadka rodziny Misiów.

Wersja polska
Opracowanie: Telewizja polska Agencja Filmowa
Reżyseria: Andrzej Bogusz
Dialogi: Katarzyna Precigs
Tłumaczenie: Agnieszka Stelmaszyńska
Dźwięk: Jakub Milencki
Montaż: Zofia Dmoch
Kierownik produkcji: Monika Wojtysiak
Grzegorz Wons
Artur Kaczmarski
Elżbieta Bednarek
Ewa Serwa  
Tomasz Bednarek
Leopold Matuszczak
Joanna Orzeszkowska
Dariusz Błażejewski
i inni

Słowa: Wiesława Sujkowska 
Opracowanie: Marian Szałkowski 
Piosenkę śpiewał: Tomasz Szwed

Spis odcinków


Linki zewnętrzne
