Bambi II – film animowany z 2006 roku w reżyserii Briana Pimentala, sequel Bambiego.

Opis fabuły
Główny bohater, Bambi, po śmierci swojej matki, zamieszkuje z ojcem, który jest powszechnie uważany za Wielkiego Króla lasu. Próbuje on nauczyć swojego syna manier, jakimi powinien odznaczać się książę. Początkowo trudno im się porozumieć. Jednak, gdy przeżywają razem dramatyczne wydarzenia, dumny ojciec przekonuje się, że to on może się jeszcze wiele nauczyć od swojego odważnego, dzielnego syna.

Twórcy
Reżyseria: Brian Pimental
Producent:''' Jim Ballantine
Muzyka:''' Bruce Broughton

Wersja polska
Opracowanie wersji polskiej: START INTERNATIONAL POLSKA
Reżyseria: Joanna Wizmur
Dialogi polskie: Joanna Serafińska
Dźwięk i montaż: Sławomir Czwórnóg
Teksty piosenek: Filip Łobodziński i Marcin Sosnowski
Wykonanie piosenek: Anna Powała, Magdalena Zawadzka, Aleksandra Szpinda, Katarzyna Szpinda, Hania Stach – dzięki uprzejmości EMI Poland
Kierownictwo muzyczne: Marek Klimczuk
Piosenki nagrano w: STUDIO BUFFO
Realizator nagrań muzycznych: Jarosław Regulski
Opieka artystyczna: Michał Wojnarowski
W wersji polskiej udział wzięli:
Beniamin Lewandowski – Bambi
Marcel Dworczyk – Tuptuś
Piotr Brzywczy – Kwiatek
Aleksandra Czarnecka – Felinka
Michał Włodarczyk – Roni
Grzegorz Pawlak – Ojciec Bambiego, Książę
Karina Szafrańska – Mama Bambiego
Ryszard Nawrocki – Sowa
Agata Buzek – Mena
Mirosław Wieprzewski – Świstak
Andrzej Fedorowicz – Jeżozwierz
Joanna Węgrzynowska – Mama Tuptusia
i inni

Produkcja polskiej wersji językowej: DISNEY CHARACTER VOICES INTERNATIONAL, INC.

Linki zewnętrzne
