Need For Speed: Carbon – komputerowa gra wyścigowa wyprodukowana i wydana w 2006 przez Electronic Arts. Jest to dziesiąta część serii gier wyścigowych Need for Speed i jednocześnie pierwsza z cyklu gra dostępna na wszystkich platformach zaliczanych do tzw. siódmej generacji. Wersja gry na PSP i Nintendo DS została wydana pod tytułem Need for Speed Carbon: Own the City.

Gra skupia się na tematyce nielegalnych wyścigów ulicznych. Gracz przejmuje w niej kontrolę nad kierowcą walczącym o wpływy z gangami kontrolującymi fikcyjne miasto Palmont. Celem gry jest zwyciężanie w kolejnych wyścigach i tym samym zdobywanie sektorów kontrolowanych przez gangi. W tym celu gracz może zbudować własną ekipę wspierającą go podczas większości starć.

Bohater główny gry przed wyjazdem do Rockport ścigał się swoim samochodem w Palmont, gdzie podczas jednego z wyścigów tamtejsza policja urządza pułapkę na kierowców. Postać gracza wymyka się i wyjeżdża do Rockport, skąd po dłuższym czasie wraca.
Gra zaczyna się (nieudaną) próbą ucieczki przed Cross'em, szefem Wydziału ds. wyścigów ulicznych policji w Rockport, po ucieczce gracza z miasta Cross wyjeżdża za nim. Samochód gracza podczas pościgu ulega zniszczeniu.
Gracz od momentu skasowania swojego BMW zaczyna grę jedną z trzech klas samochodów (Tuningowane, Muscle, Egzotyczne). Celem gry jest przejęcie całego Palmont, i odzyskanie szacunku w mieście.

Gra jest bardzo mocno połączona z poprzednią częścią –  ponieważ jest jej bezpośrednią kontynuacją.

Bohaterowie
Neville
Sal
Yumi – BUSHIDO
Colin – T.F.K
Samson – 21st.STREET
Darius - Stacked Deck
Nikki

Soundtrack
Dynamite MC – Bounce
Dynamite MC – After Party
Ekstrak feat. Know-1 – Hard Drivers
Eagles of Death Metal – (Don't Speak) I Came to Make a Bang
Every Move a Picture – Signs of Life
Gary Numan/Tubeway Army – Are "Friends" Electric
Grandmaster Flash and The Furious Five – Scorpio
Goldfrapp – Ride a White Horse (Serge Santiago Remix)
Kyuss – Hurricane
Lady Sovereign – Love Me or Hate Me
Ladytron – Sugar (Jagz Kooner Remix)
Ladytron – Fighting In Built Up Areas
Melody. – Feel The Rush (Junkie XL Remix)
Metro Riots – Thee Small Faces
Part 2 feat. Fallacy (band)|Fallacy – One of Dem Days (Remix)
Pharrell feat. Lauren – Skateboard P presents: Show You How to Hustle
Priestess (band)|Priestess – I Am the Night, Colour Me Black
Roots Manuva – No Love
Spank Rock – What It Look Like
Sway DaSafo|Sway – Hype Boys
The Bronx (band)|The Bronx – Around the Horn
The Presets – Steamworks
The Vacation (band)|The Vacation – I'm No Good
Tiga (musician)|Tiga – Good As Gold
Tigarah – Girl Fight (Mr. D Hyphy Mix)
Tomas Andersson – Washing Up (Tiga Remix)
Valient Thorr – Heatseeker
Vitalic – My Friend Dario
Wolfmother – Joker & the Thief
Yonderboi – People Always Talk About the Weather (Junkie XL Remix)

Linki zewnętrzne
