Horton słyszy Ktosia (ang. Horton Hears a Who!'' lub Dr. Seuss’ Horton Hears A Who!'', 2008) – amerykański film animowany wykonany przy pomocy CGI na podstawie opowiadania Dr. Seussa.

Obsada
Jim Carrey – Horton
Steve Carell – Burmistrz
Carol Burnett – Kangurowa
Jesse McCartney – Jojo O’Malley
Will Arnett – Vlad Vladikoff
Seth Rogen – Morton
Amy Poehler – Sally O’Malley
Josh Flitter – Rudy
Dan Fogler – Yummo
Isla Fisher – Doktor Larue
Jonah Hill – Tommy
Selena Gomez – Córka burmistrza

Wersja polska
Opracowanie i udźwiękowienie wersji polskiej: STUDIO SONICA
Nagrań dokonano w: STUDIO MAFILM W BUDAPESZCIE
Reżyseria: Miriam Aleksandrowicz
Dialogi polskie: Joanna Kuryłko
Narracja – tekst i wykonanie: Rafał Bryndal
Realizacja dźwięku: György Fék, Jacek Osławski, Agnieszka Stankowska, Thomas Markus
Kierownik muzyczny: Agnieszka Tomicka
Kierownictwo produkcji: Agnieszka Kudelska
W wersji polskiej udział wzięli:
Michał Żebrowski – Horton
Bartosz Opania – Burmistrz
Rafał Bryndal – Narrator
Małgorzata Zajączkowska – Kangurowa
Mirosław Zbrojewicz – Vlad
Andrzej Grabarczyk – Przewodniczący
Piotr Kozłowski – Morton
Magdalena Stużyńska-Brauer – Żona Burmistrza
Karina Szafrańska – Panna Wrzask
Jakub Molęda – Jo-Jo
i inni

Wykonanie piosenek: 
Bartosz Opania, 
Michał Żebrowski, 
Mirosław Zbrojewicz,
Magdalena Stużyńska-Brauer
Jakub Molęda

Ktosiowo:
Katarzyna Pysiak, Beata Wyrąbkiewicz, Jacek Czyż, Adam Krylik, Robert Kudelski, Modest Ruciński, Agnieszka Tomicka
oraz Chór „PRO FORMA” pod kierownictwem Marcina Wawruka



Linki zewnętrzne
