Franklin i skarb jeziora (ang. Franklin and Granny’s Secret, fr. Franklin et le trésor du lac, 2006) – kanadyjsko-francuski film animowany. Babcia Franklina przypomina sobie, jak w dzieciństwie spędzonym nad Jeziorem Żółwi zakopała w ziemi kapsułę czasu z przedmiotami należącymi do członków jej rodziny.

Wersja polska
Wersja polska: STUDIO SDT
Reżyseria: Andrzej Precigs
Dialogi: Katarzyna Precigs
Tłumaczenie: Katarzyna Precigs
Teksty piosenek: Wiesława Sujkowska
Kierownik produkcji: Andrzej Precigs
Produkcja: Polmedia Maciej Taras
Piosenki śpiewali: Małgorzata Kożuchowska, Lidia Kopania (Obudź marzenia)
Wystąpili:
Joanna Jabłczyńska – Franklin
Artur Barciś – Tata Franklina
Iwona Rulewicz –
Mama Franklina,
Wrona
Małgorzata Kożuchowska – Kuzynka Sapcia
Maciej Rock – Niedźwiedź
Paweł Szczesny – Miś
Grażyna Wolszczak – Ciocia Lusia
Mirosława Niemczyk –
Doktor Misiowa,
Orlica
Mirosława Krajewska – Babcia Franklina
Krystyna Tkacz – Wróżka
Magdalena Krylik – Sabinka
Jarosław Domin – Bóbr
Joanna Pach – Ślimak
Matylda Taras – Pisklę #3'''
Małgorzata Zbierańska – Pisklę #1'''
Kaja Maliszkiewicz – Pisklę #2'''
Julia Niewęgłowska – Maleńka
Andrzej Precigs
i inni

Piosenki:
Memories
Słowa i muzyka: Ray Parker, Tom Szczesniak i Jeen O'Brien
Oryginalne wykonanie: Jeen O'Brien

Getting There Is Half The Fun Fun Fun Fun
Kompozytor: Anthony Vanderburgh i Don Breithaupt
Oryginalne wykonanie: Rikki Rumbell

Tekst polski: Wiesława Sujkowska
Wykonanie: Małgorzata Kożuchowska

Linki zewnętrzne
