Władca Pierścieni (ang. The Lord of the Rings) – amerykański film animowany z 1978 roku. Film jest pierwszą ekranizacją powieści J.R.R. Tolkiena, Władca Pierścieni.

Ekranizacja obejmuje ok. półtora tomu powieści (do bitwy w Helmowym Jarze).

Animacja została zrealizowana techniką rotoskopową.

Obsada
Christopher Guard – Frodo Baggins
William Squire – Gandalf Szary
Michael Scholes – Samwise Gamgee
John Hurt – Aragorn
Simon Chandler – Meriadok Brandybuck
Dominic Guard – Peregrin Tuk
Norman Bird – Bilbo Baggins
Michael Graham Cox – Boromir
Anthony Daniels – Legolas
David Buck – Gimli
Peter Woodthorpe – Gollum
Fraser Kerr – Saruman
Philip Stone – Théoden
Michael Deacon – Gríma
André Morell – Elrond, Celeborn
Alan Tilvern – właściciel gospody
Annette Crosbie – Galadriela
John Westbrook – Drzewiec
i inni

Wersja polska
Wersja polska: Telewizyjne Studia Dźwięków w Warszawie
Reżyseria: Dorota Kawęcka
Dialogi: Grażyna Dyksińska-Rogalska
Tłumaczenie: Maria Skibniewska
Dźwięk: Wiesław Jurgała
Montaż: Danuta Rajewska
Kierownictwo muzyczne: Piotr Gogol
Kierownictwo produkcji: Krystyna Dynarowska

Wystąpili:


Przypisy


Linki zewnętrzne
