Bystre Oko (wł. Un occhio acuto, ang. Wide Eye, 2008) – brytyjsko-włoski serial animowany, który emitowany jest w Polsce na kanale MiniMini od 11 lutego 2010 roku.

Opis fabuły
Serial opowiada o przygodach Sówki Małe Oczko i jego najlepszego przyjaciela Pchły. Opiekunem „Chichoczącego lasu” jest tata małej sówki Bystre Oko, który służy radą i pomocą wszystkim mieszkańcom.

Bohaterowie
Małe Oczko – sówka, syn Bystrego Oka.
Pchła – najlepszy przyjaciel Małego Oczka.
Bystre Oko – tytułowy bohater serii, ojciec Małego Oczka oraz opiekun lasu.

Wersja polska
Opracowanie wersji polskiej: na zlecenie MiniMini – Start International Polska
Reżyseria: Marek Klimczuk
Dialogi polskie: Andrzej Wójcik
Tekst piosenki: Jakub Osiński
Dźwięk i montaż: Hanna Makowska
Kierownik produkcji: Elżbieta Araszkiewicz
W wersji polskiej udział wzięli:
Stefan Knothe – Bystre Oko
Agnieszka Fajlhauer – Małe Oczko
Barbara Melzer – Pchła
Krzysztof Zakrzewski – Witold
Dominika Sell – Wojtek
Jan Kulczycki – Pan Chichoczący
Paweł Szczesny – '''99'''
Joanna Pach - Anita
Anna Apostolakis
Robert Tondera
Elżbieta Kopocińska-Bednarek
i inni

Piosenka w wykonaniu: Adama Krylik i Barbary Melzer

Lektor: Tomasz Knapik

Spis odcinków


Linki zewnętrzne
