X-Men: Ostatni bastion – kanadyjsko–amerykański–brytyjski film akcji w reżyserii Bretta Ratnera z 2006 roku.

X-Men 3 jest trzecią częścią trylogii X-Men. Fabuła filmu oparata jest na komiksach z cyklu „The Dark Phoenix Saga” i „Astonishing X-Men: Obdarowani”

Fabuła
Wobec wynalezienia leku neutralizującego mutacje, mutanci stają przed koniecznością wyboru swojej przyszłości. Profesor Charles Xavier uważa, iż lek umożliwi wielu mutantom powrót do normalnego życia, z dala od dyskryminacji, natomiast Magneto, iż ludzie boją się mutantów i chcą ich zlikwidować. Magneto tworzy armię, której sprzeciwiają się X-Men pod wodzą Wolverine'a, Storm i Hanka McCoya, stając do walki z Magneto.

Obsada
Patrick Stewart – Profesor Charles Xavier
Hugh Jackman – Logan, Wolverine
Anna Paquin – Rogue
Ian McKellen – Eric Lensherr, Magneto
Halle Berry – Ororo Munroe, Storm
Famke Janssen – Jean Grey, Dark Phoenix
James Marsden – Scott Summers, Cyclops
Rebecca Romijn – Raven Darkholme, Mystique
Kelsey Grammer – Hank McCoy, Bestia
Vinnie Jones – Juggernaut
Aaron Stanford – John Allerdyce, Pyro
Daniel Cudmore – Peter Rasputin, Colossus
Ben Foster – Warren Kenneth Worthington III, Angel
Shawn Ashmore – Bobby Drake, Iceman
Olivia Williams – Dr Moira McTaggert
Ellen Page – Kitty Pryde, Shadowcat
Shohreh Aghdashloo – Dr Kavita Rao
Eric Dane – Jamie Madrox, Multiple Man

Nagrody i nominacje
Nagrody Saturn 2006'''
Najlepsza aktorka drugoplanowa – Famke Janssen
Najlepszy film SF (nominacja)
Najlepsze kostiumy – Judianna Makovsky (nominacja)
Najlepsza muzyka – John Powell (nominacja)
Najlepsze efekty specjalne – John Bruno, Eric Saindon, Craig Lyn, Michael Vezina (nominacja)
Najlepszy aktor drugoplanowy – Kelsey Grammer (nominacja)
Nagroda Satelita 2006'''
Najlepszy montaż – Mark Helfrich, Mark Goldblatt, Julia Wong
Najlepsze zdjęcia – Dante Spinotti (nominacja)
Najlepszy dźwięk – Steve Maslow, Doug Hemphill, John A. Larsen, Rick Klein (nominacja)
Najlepsze efekty specjalne – John Bruno (nominacja)

Bibliografia
